t...a....t
..ww......
.wt.w..a..
.w....w.w.
.w...wwwww
aw....w.w.
.w.k.wwwww
.w....w.w.
.w..w...a.
t.ww.a...t
