t...a....t
..##......
.wt.w..a..
.w....w.w.
.w...w=w=w
aw....w.w.
.w.k.w=w=w
.w....w.w.
.w..w...a.
t.##.a...t